EA ./textures/wood.xpm
NO ./textures/redbrick.xpm
SO ./textures/bluestone.xpm
WE ./textures/purplestone.xpm

F 255,200,241
C 100,100,255

        1111111111111111111111111
        1000000000110000000000001
        1011000001110000000000001
        1010001111111111000011111
        1001000000000000000000001
111111111011000001110000000000001
100000000011000001110111111111111
11110111111111011100000010001
11110111111111011111010010001
11000000110101011111000000001
10000000000000111100010000001
1000S000000000000110101001001
11000001110101011111010000001
11110111 1110001 101111010001
11111111 1111111 111111111111
